XXXXXXXXXXXXXXX
XS$         $SX
X$           $X
X             X
X             X
X             X
X             X
X             X
X             X
X             X
X$           $X
XS$         $SX
XXXXXXXXXXXXXXX